# Left - russian, right - latin
А=A
Б=B
В=V
Г=G
Д=D
Е=E
Ё=E
Ж=ZH
З="Z
И=I
Й=I
К=K
Л=L
М=M
Н=N
О=O
П=P
Р=R
С=S
Т=T
У=U
Ф=F
Х=H
Ц=C
Ч=CH
Ш=SH
Щ=SH
Ъ=*
Ы=Y
Ь=*
Э=E
Ю=U
Я=YA
